111003202111
121002301101
111003202011
000002301101
000003202111
000002300000
111203200000
101102300000
110203200111
101102300121
111203200111
