11111111111111
22222111122222
20002211220002
22000222200022
12200022000221
11220000002211
11122044022111
11122044022111
11220000002211
12200022000221
22000222200022
20002211220002
22222111122222
11111111111111