222211112222
000221122000
200021120002
220002200022
122000000221
111204402111
111204402111
122000000221
220002200022
200020020002
000221122000
222211112222
