111110011111
110220022011
102200002201
122000000221
000021120000
000021120000
122000000221
102200002201
110220022011
111120021111
