00000000000000
00000000000000
00000011000000
00000111100000
00001111110000
00011111111000
00111100111100
00111100111100
00011111111000
00001111110000
00000111100000
00000011000000
00000000000000
00000000000000