11111111111111
11111111111111
11111100111111
11111000011111
11110000001111
11100000000111
11000011000011
11000011000011
11100000000111
11110000001111
11111000011111
11111100111111
11111111111111
11111111111111