001110000001100
011011000010010
110001111100001
100000000000001
100000000000010
100000000000001
110001111100001
011011000010010
001110000001100