11111111111111
11111222211111
11112222221111
11122000022111
11220000002211
12200000000221
12000011000021
12000011000021
12200000000221
11220000002211
11122000022111
11112222221111
11111222211111
11111111111111