003001100300
022200002220
324230032423
022200002220
003003300300
000022220000
000321123000
400321123004
000022220000
010003300010
121000000121
010011110010