222214412222
001221122100
200021120002
220002200022
122000000221
111203302111
111203302111
122000000221
220002200022
200021120002
001221122100
222214412222
