001111111100
011220022110
112200002211
122000000221
210021120012
210021120012
122000000221
112200002211
011220022110
001121121100
