440222222044
110220022011
110200002011
000000000000
220301103022
220301103022
220301103022
000000000000
110200002011
110220022011
110233332011
330211112033