111443244111
121002300121
111003200111
000000000000
000032230000
000031130000
000032230000
000000000000
111003200111
121002300121
111443244111
